x=25, y=25,
@@@@@@@@@@@@@@@@@@@@@@@@@
@      #           @    @
@@#@@@@@@ @@@@@@@#####@ @
@     #         #       @
@ @@@@#@@@@@@#@@@@@@@###@
@        @        @     @
@@@@@  @@@@@@@@@@#####@@@
@    @          #       @
@@@@ ##@@@@@@ @@@@@ @@@@@
@             ##        @
@#@@#@#@@@#@@@## @@@@@@ @
@      #     @  @    @@ @
@  @   #  @  #      #   @
@@@@@@@@@@@@@@@@@@@@@@@@@