@@@@@@@@@@@@@@@
@      @@     @
@@@@   @@ @@@ @
@             @
@ @@@@#@@  @@#@
@             @
@ @@@  @@  @@ @
@   @@        @
@ @@###@@@@@@ @
@   #         @
@#@@#  @@@#@@ @
@      #     @@
@ @@   #   @  @
@@@@@@@@@@@@@@@