111111111111111
100000011000001
111100011011101
100000000000001
101111211001121
100000000000001
101110011001101
100011000000001
101122211111101
100020000000001
121120011121101
100000020000011
101100020001001
111111111111111